NO ./textures/swastika.xpm
SO    ./textures/wall_wolfenstein_1.xpm
WE       ./textures/wall_wolfenstein_3.xpm
EA                    ./textures/tnt.xpm

F         225,           30,30  
FT ./textures/grass_brick.xpm
CT ./textures/sky_soft.xpm
C   100,255,255     

111
 101111
10000011
1001001
1N02001
100100011
10010011
10112101
1000011
1111111

