NO ./textures/brickwall.xpm
SO    ./textures/grass.xpm
WE       ./textures/stone.xpm
EA                    ./textures/tnt.xpm

F                  100,255,255
C 225,           30,30

11111
11001
 1111
1W001
 1011
  1