NO ./textures/brickwall.xpm
SO    ./textures/grass.xpm
WE       ./textures/stone.xpm
EA                    ./textures/tnt.xpm

F                  100,255,255
C 225,           30,30

        1111111111111111111111111
        100000000000000000000001
        100000000000000000000001
        100000N000000000000000001
11111111100000000000000000000001
10000000000000000000000000111111
11110000000000000000000000010001
11110000000000000000000000010001
11000000110101011100000010001111
10000000000000001100000010001
10000000000000001101010010001
110000011101010111110111110111
11110111 1110101 101111010001
11111111 1111111 111111111111