NO ./textures/sea4.xpm
SO    ./textures/sea1.xpm
WE       ./textures/sea2.xpm
EA                    ./textures/sea3.xpm

CT ./textures/clear.xpm
FT ./textures/sand.xpm
F          210, 209, 200
C   153, 224, 255




11111111
1101011
10012111111
100100010001
10020000111
10010121111
1001S100001
10112100001
10000100011
1111111111

