NO ./textures/swastika.xpm
SO    ./textures/wall_wolfenstein_1.xpm
WE       ./textures/wall_wolfenstein_3.xpm
EA                    ./textures/tnt.xpm

F          113, 127, 143
C   71, 47, 47    

11111111
1101011
10012111
10000001
10010111111
100100010001
10020N02011
10010101111
10010100001
10112100001
10000000011
111111111

