NO ./textures/brickwall.xpm
SO    ./textures/grass.xpm
WE       ./textures/stone.xpm
EA                    ./textures/tnt.xpm

F         225,           30,30       
FT ./textures/grass_brick.xpm
CT ./textures/sky_soft.xpm
     C   100,255,255

111
 101111
10000011
1001001
1N02001
100101011
10111101
1000011
1111111

