

  1111111111
 1110000000111
 110000000N0111
 1011111101111
 11 1 1 11111
    1 1