NO ./path_to_the_north_texture.xpm
SO    ./path_to_the_south_texture.xpm
WE       ./path_to_the_west_texture.xpm
EA                    ./path_to_the_east_texture.xpm

F                  100,255,255
C 225,           30,30

11111111
10000N01
11111111