NO ./textures/brickwall.xpm
SO    ./textures/grass.xpm
WE       ./textures/stone.xpm
EA                    ./textures/tnt.xpm

F         171,           139,98       
     C   100,255,255

111
 101111
1W00001
10110101
 100011
  11111