NO ./textures/mossy_wall.xpm
SO ./textures/mossy_wall.xpm
WE ./textures/mossy_wall.xpm
EA ./textures/mossy_wall.xpm

F         225,           30,30       
FT ./textures/grass_brick.xpm
CT ./textures/sky_soft.xpm
     C   100,255,255



        1111111111111111111111111
        1000000000110000000000001
        101100001110000000000001
        100100N000000000000000001
111111111011000001110000000000001
100000000011000001110111110111111
11110111111111011100000010001
11110111111111011101010010001
11000000110101011100000010001
10000000000000001100000010001
10000000000000001101010010001
110000011101010111110111110111
11110111 1110101 101111010001
11111111 1111111 111111111111

