

texture









1111111111111111111111111111111N
    111111111
 1110000000111                  
 1100001000111                 
 1011011101111                  
 11 111 11111
    1 1     11
   111111111111111111111111111
1
      1
           1
1
      1
            1
1
S






         
           