

texture









11111111111111111111111111111111
    111111111
 1110000000111                  
 110000100N0111                 
 1011011101111                  
 11 111 11111
    1 1     11
   111111111111111111111111111
1
      1
           1
1















         
           