1111111
1000001
10011001
101111111
10011
 11